$$$ exec p1 : [players/test.filler]
$$$ exec p2 : [players/gmolin.filler]
Plateau 15 17:
    01234567890123456
000 .................
001 .................
002 .................
003 .................
004 .................
005 .................
006 .................
007 .........x.......
008 ..OO..xxxxxxxxxxx
009 ...O.....xxxxxxxx
010 ............x....
011 ............xx...
012 .............xX..
013 .................
014 .................
Piece 2 2:
.*
**