$$$ exec p1 : [players/gmolin.filler]
$$$ exec p2 : [players/test.filler]
Plateau 15 17:
    01234567890123456
000 .................
001 .................
002 .................
003 .................
004 .................
005 .................
006 .OO..............
007 OOOOO............
008 OOO..............
009 ...........x.....
010 ...........xXX...
011 .............XX..
012 .............XX..
013 .................
014 .................
Piece 1 3:
***