$$$ exec p1 : [players/gmolin.filler]
$$$ exec p2 : [players/test.filler]
Plateau 15 17:
    01234567890123456
000 .................
001 .................
002 .................
003 .................
004 .................
005 .................
006 .................
007 .................
008 ..O..............
009 .................
010 .................
011 .................
012 ..............X..
013 .................
014 .................
Piece 2 1:
*
*
<got (O): [7, 2]
Plateau 15 17:
    01234567890123456
000 .................
001 .................
002 .................
003 .................
004 .................
005 .................
006 .................
007 ..o..............
008 ..o..............
009 .................
010 .................
011 .................
012 ..............X..
013 .................
014 .................
Piece 2 2:
**
.*
<got (X): [11, 13]
Plateau 15 17:
    01234567890123456
000 .................
001 .................
002 .................
003 .................
004 .................
005 .................
006 .................
007 ..O..............
008 ..O..............
009 .................
010 .................
011 .............xx..
012 ..............x..
013 .................
014 .................
Piece 2 3:
.*.
***
<got (O): [6, 0]
Plateau 15 17:
    01234567890123456
000 .................
001 .................
002 .................
003 .................
004 .................
005 .................
006 .o...............
007 ooo..............
008 ..O..............
009 .................
010 .................
011 .............XX..
012 ..............X..
013 .................
014 .................
Piece 2 2:
.*
**
<got (X): [10, 12]
Plateau 15 17:
    01234567890123456
000 .................
001 .................
002 .................
003 .................
004 .................
005 .................
006 .O...............
007 OOO..............
008 ..O..............
009 .................
010 .............x...
011 ............xxX..
012 ..............X..
013 .................
014 .................
Piece 2 2:
.*
**