$$$ exec p1 : [players/gmolin.filler]
$$$ exec p2 : [players/test.filler]
Plateau 15 17:
    01234567890123456
000 .................
001 .................
002 .................
003 .................
004 .................
005 .................
006 .................
007 .........x.......
008 ..OO.xxxxx.......
009 ...O.....xxxx....
010 ............x....
011 ............xx...
012 .............xX..
013 .................
014 .................
Piece 4 2:
..
**
*.
*.