$$$ exec p1 : [players/gmolin.filler]
$$$ exec p2 : [players/test.filler]
Plateau 15 17:
    01234567890123456
000 .................
001 .................
002 .................
003 .................
004 .................
005 .................
006 .................
007 .................
008 ..Oo.............
009 ...o.............
010 .................
011 .............x...
012 .............xX..
013 .................
014 .................
Piece 6 5:
...*.
..***
..***
.....
.....
.....
